1111111111
1000000001
1000000001
1000000001
1000000001
1000000000
1000000000
1000000001
1000000001
1111111111